$ANSIBLE_VAULT;1.1;AES256
38613132623730626531386537643637616635623430356663636334373931663166373533663465
3938393063653332666632643237626262393966613834320a656331346334626265326439616234
38383535373735646236373338663764633262366239356636343334623337333634623030333438
6332353231373066300a363834373936356365363863653362383564656462663837663837316363
35326262376566333739633663323163356635396562613861313836313263623034613539376237
33643333616435623936323836366538393438303263666130326437333432313832323533373335
323835363032666665616337363432373365
