$ANSIBLE_VAULT;1.1;AES256
66333131666630356137323761323663303232363236323630383766656330373033343139616635
3438323734376663636465386462373565643765656166370a323730346634366266353137343366
39666431393663366661613665616438336666383834653331383632636232643936353730383231
3063356264636438320a363961653764363036653464623536643036336633326330643062653765
66663363303563353333323831336162363337663465313234333137326362356439356562383162
32306134333538346263633032373635323065643839373631333430313031393333383937323133
65626231663437343131393539343366653661343634626230633966616664353031643337623132
37346165396339363639623233313666623263633263626439393731343261326131366639326562
34346665303861373365653463316234306466653534346239666333643364313034356337386335
62653139336130383464343234666464363262626336343165363439346435376633613034323261
31653134316262643932336463383938653430346531366562626131346462616365636631376635
38373134653131393661623230663035346363653233623264386634303137356438653437333262
34626331656137333735613832646564653336346339623835343466636533623339316166623338
61373666396633323834666433316433633431353337336165623034373036623163343236326238
66323330313566663466643165636230626535306462396238653238626231623036336264366436
65323064633866663831313132383332643562646664343865353261633137633138383639373462
39326363643133613836386136353532666364323030306334363265353738633434363735623661
39633631393533336466333161336236323962633130373164323765383237653061306630626638
30303036313838656664663134633261333335306436646461643438373036396661366532376637
36393631366337366466383932363337623630363563306561623162646130303730303230346338
61363563323133393563353438313961333638353038306633323235366638303131373539636665
65666238666464356634613164353834373830353562303036313763336566653930643136643533
313966386237656664343766323262616439
